NOR	Northern Europe
EST	Northern Europe
RUS	Eastern Europe
SGP	South-Eastern Asia
GIN	Western Africa
PNG	Melanesia
ISR	Western Asia
RWA	Eastern Africa
FRA	Western Europe
KOR	Eastern Asia
GNQ	Middle Africa
IND	Southern Asia
AGO	Middle Africa
CMR	Middle Africa
AUT	Western Europe
HKG	Eastern Asia
MDV	Southern Asia
GUY	South America
BHS	Caribbean
GBR	Northern Europe
ROM	Eastern Europe
DEU	Western Europe
NAM	Southern Africa
SEN	Western Africa
SUR	South America
MLI	Western Africa
BEN	Western Africa
BIH	Southern Europe
AZE	Western Asia
NGA	Western Africa
CIV	Western Africa
KAZ	Central Asia
THA	South-Eastern Asia
TTO	Caribbean
TCD	Middle Africa
COL	South America
BWA	Southern Africa
TZA	Eastern Africa
FJI	Melanesia
COG	Middle Africa
JPN	Eastern Asia
KGZ	Central Asia
QAT	Western Asia
UKR	Eastern Europe
MDA	Eastern Europe
PRT	Southern Europe
MUS	Eastern Africa
AUS	Australia and New Zealand
PRY	South America
GRC	Southern Europe
BLR	Eastern Europe
NPL	Southern Asia
TJK	Central Asia
BRN	South-Eastern Asia
BDI	Eastern Africa
MKD	Southern Europe
LBN	Western Asia
NIC	Central America
VEN	South America
ARM	Western Asia
PAN	Central America
MYS	South-Eastern Asia
ALB	Southern Europe
ISL	Northern Europe
MWI	Eastern Africa
GHA	Western Africa
URY	South America
MNG	Eastern Asia
TGO	Western Africa
SVK	Eastern Europe
BGR	Eastern Europe
OMN	Western Asia
JOR	Western Asia
ARE	Western Asia
BGD	Southern Asia
POL	Eastern Europe
ARG	South America
SVN	Southern Europe
AFG	Southern Asia
CZE	Eastern Europe
IDN	South-Eastern Asia
BLZ	Central America
SWE	Northern Europe
MAR	Northern Africa
GEO	Western Asia
BRA	South America
GTM	Central America
LVA	Northern Europe
LKA	Southern Asia
TUR	Western Asia
FIN	Northern Europe
IRQ	Western Asia
EGY	Northern Africa
HUN	Eastern Europe
PHL	South-Eastern Asia
UGA	Eastern Africa
BEL	Western Europe
LAO	South-Eastern Asia
NZL	Australia and New Zealand
DOM	Caribbean
LUX	Western Europe
CYP	Eastern Europe
ZWE	Eastern Africa
SLV	Central America
BFA	Western Africa
KEN	Eastern Africa
LBY	Northern Africa
MOZ	Eastern Africa
MEX	Central America
CPV	Western Africa
DZA	Northern Africa
CRI	Central America
UZB	Central Asia
BOL	South America
DNK	Northern Europe
HTI	Caribbean
VNM	South-Eastern Asia
HRV	Southern Europe
SAU	Western Asia
SWZ	Southern Africa
CAN	Northern America
NER	Western Africa
PER	South America
USA	Northern America
BHR	Western Asia
LTU	Northern Europe
CHE	Western Europe
PAK	Southern Asia
ZAF	Southern Africa
ECU	South America
HND	Central America
ESP	Southern Europe
JAM	Caribbean
MLT	Southern Europe
ZMB	Eastern Africa
KHM	South-Eastern Asia
IRL	Northern Europe
CHN	Eastern Asia
YEM	Western Asia
MDG	Eastern Africa
TUN	Northern Africa
KWT	Western Asia
NLD	Western Europe
ITA	Southern Europe
CHL	South America
